C 79, 88, 89
F 33,59,23
NO  textures/colorstone.xpm
WE textures/purplestone.xpm

EA textures/redbrick.xpm
SO textures/eagle.xpm

111111111111111111111111111111111
100000000001000000000001000000001
10110000010100000N000001000000001
100100000000000000000001000010001
111111111011000001010000000000001
100000000001000001010111111111111
111101011111111101000000100001001
100001000000000101010100100001001
111101111111110101000000100000001
100000000000000000000000000001001
100000100000000010010100100000001
111110010101010110100111101001001
100000010001010100010000100001001
111111111111111111111111111111111
