C 79, 88, 89
F 33,59,23

EA ./textures/wood0.xpm
NO ./textures/wood1.xpm
SO ./textures/wood2.xpm
WE ./textures/wood3.xpm

1111111111
1000000001
1111000001
1000000001
100W001001
1000001001
100000100111111111
111111100000000001
      100000000001
      100000000001
      100001110111
      100001000001
      100001000001
      111111111111
