C 79, 88, 89
F 33,59,23

EA ./textures/wood0.xpm
NO ./textures/wood1.xpm
SO ./textures/wood2.xpm
WE ./textures/wood3.xpm
   
                     
    
        1111111111111111111111111
        1000000000000000000100001
        10000000100000E0000100001
        1011000101000000001 10001
        1001000010000000010100001
        1001000000000000010100001
111111111011000001110000001000001
100000000011000001110111111111111
11110111111111011100000010001    
11110111111111011101010010001    
11000000110101011100000010001    
10000000000000001100000010001    
10000000000000001101010010001    
1100000111010101111101111000111  
11110111 1110101 101111010001    
11111111 1111111 111111111111    

                 
                      

                 
