C 79, 88, 89
F 33,59,23

EA wood0.xpm          
NO wood1.xpm
SO wood2.xpm
WE wood3.xpm

1 1
11N1
1111111111111
